Legenda: S=inicio, C=coleta, D=doca, G=fim, X=obstaculo, ~=congestionamento
Celulas especiais podem combinar marcadores, como DG para doca final.
Inicio: (12, 21)
Coleta: (18, 1)
Docas: [(5, 45), (20, 45), (35, 45), (45, 45)]
Pacotes: [{'id': 1, 'doca': (45, 45), 'prio': 3}, {'id': 2, 'doca': (45, 45), 'prio': 2}, {'id': 3, 'doca': (45, 45), 'prio': 2}]

X . . ~ . . . . X . . . . . ~ X . ~ . . . . X . . X ~ X . . . . . . . . X . X . . . . . . X . . . X 
. . ~ X . . . . . . . . . ~ . . . . . . ~ . X . X . . . . . ~ . . . . ~ ~ . . . X . . . . X X ~ X . 
. . X . . X ~ X . . . . . . . . ~ . ~ . . X . . . . . . . X . X . . . . . . X . . ~ . . X X . ~ . . 
. . . X . X ~ X . . . . . . . . . . . . . . . . . X . . . . . . X X . . . ~ . X ~ ~ . X . . . . . . 
X X . ~ . . . . . . ~ . . . . . . X . ~ . . . . . . X . . . ~ . . . . . . . . . X X . ~ . . . . . . 
. . . . . . . . . ~ ~ . . . . . . . . X ~ . . . . . X . X . . . . . . . . X . X ~ . . . . D . . . X 
. . . . . ~ X X . . . ~ . . . . . . ~ . . . . . . . . . . X . . X X . . . X . ~ . . . . . . . ~ X . 
. . . . X . . . . . ~ ~ . . . . X . X . . . . . . . . X . . X . . X . . . X . . . . . ~ . . . ~ X . 
. X X . X . . . . . . . X . . . . . . . . . X . . . . . . . X ~ X X . . . . X . . . . ~ . . . . . X 
. . X . . . . . . . . . . . . . . ~ . X . . . . . X X . . . . X . . . . . . . . . X ~ . . . X . . . 
. . . . . . ~ . . . . X . . X X ~ ~ . . . . . . . . . ~ X . . . X X . . . . . . . . . X . . . . . ~ 
. . . X X . . . . . . . . . . . X . ~ . . . . . X X . ~ . . ~ ~ X ~ ~ . . . ~ ~ . . . . . . . . . ~ 
X . . ~ . . . . X X . ~ X . ~ . . X X X v S . X X . . . . . . . . . . . . . . X . . . . . . . . X . 
. X X . . ~ . . . . . . . . ~ . . . v < < . . . . . . . . . . . . . X . . . . . ~ . . . . . . . ~ . 
. X . . X ~ . . X . v < < < < < < < < X . . . ~ . . . . . . . . . . . ~ . . . . ~ ~ . . . . X . . . 
X . X . . . . X X v < . X . X ~ . X ~ ~ . . . X . ~ . . . . X X X . . . . X . ~ . ~ . . . . X . X . 
. X X . . . ~ v < < . . . . . . X . . . . . . . . . . . . . . . . . X . . . ~ X . . . . X X . . . . 
. . . ~ v < < < X . X ~ . X . . . . . X . . X . . X . . X X . X ~ . X . X ~ . . . . . X . . . . . X 
. C > > > > v . X X . . . . . X . . . . . . . . X . ~ . X . . . . X ~ . X . . . . ~ . ~ . X X . . X 
. ^ < . X X v X . . . . X . . . ~ . ~ ~ . X . . X . . . . . . X . . X . . . . . ~ X . . . X . X . . 
. X ^ . . . v ~ . . . . . X . . . . . . ~ . . . X . X . . X . ~ . . . . . . . . . . . ~ . D . . X . 
. . ^ ~ . . > > v . . . X . . . . . X . . . ~ X X . . . . . . . . . . . X . . . . X . ~ . . . . X . 
. ~ ^ . ~ ~ X . > v X . . . . . . . ~ . . . . . . . ~ X . . . . . . . ~ X . . ~ . . X X . . X . . . 
. . ^ . . ~ . . . > v ~ . . . . . . . . . . . ~ . X X . . . ~ . . . . . . . . . X . . . . X . . . . 
. . ^ . . ~ . . X X > v . . X . X . . . . ~ . . . . . . . . . . X . . ~ . ~ ~ . . . . . . . . . ~ ~ 
. . ^ X X . X . . . . > > > v ~ . ~ X ~ . X . . . . . . . . X . . X . . X . X . . . . . . . . . . . 
. . ^ < ~ X X . X . . . . . > v X . . . X . X X . . . . . . . . . X . . . . . X . . . . . . . . . . 
. X . ^ ~ . . . . X X . . ~ X v . . . . ~ ~ . . X . . . . . X . . . . X . . . . . . . . . ~ . ~ . X 
. . . ^ < < < . . . X . . X X v . X . . X . X . . . X . . . . . . . . . X . . . . . . X . X . X . X 
~ . . . X ~ ^ . . . . ~ . . . v . . ~ . ~ . . . . . . X . . . . . . . . . . . . ~ . . . . . . X ~ . 
. . ~ . . X ^ ~ X X . X ~ . X > > > v . X . . . . . . . . X . . . . . X . . . . . . X . . . . . . . 
. . . . . X ^ < < X . X . ~ . . . X v X . . . . . ~ . X . . . X . . . . . . . . . . . . X . . . X ~ 
X . . . . X . . ^ . . . . . X . ~ . > v X . . . . . . . . . . ~ . . X . . . . . . . . . . . . . . ~ 
. X . . . X . . ^ . . . X . . . . . ~ v . X . . . . . ~ . . . . . . . . . ~ . . . X X . . . . . X . 
. . . X . X . . ^ < < . . . . . . . . v . X X . . X . X . X . . . . . . . . . X . . . . X . ~ ~ . . 
. . . . . X ~ . . . ^ < < < < X . . . > > > v X . X . . . . X . . X . X . X . X ~ . X ~ . D . . X . 
X . . . . . . X X . . . . X ^ < < < < < < < > > > > v X X . . . X . . . . . X . ~ . . . X . . . . X 
~ . . . . . . . . . . . X ~ . ~ . . X X . ^ < < . . > > v X . . . . . . . . X . . . X . X . ~ . ~ . 
. ~ . ~ X . . . . . . . . . . ~ ~ X X X . X ~ ^ < < < X > > > > > > v ~ . . X X . X X . X . . X . . 
. X . . . . . . . . X . ~ . . X . . . . . . . . . X ^ . X . ~ X . . > > v . . . . . ~ X . . . X . . 
. . . . . . . . . . X . X X . X ~ X . . . . . . . X ^ X ~ X . X X . . . v X . . . . X . ~ X . ~ . . 
. . . . . . . . . . . . X . . . . ~ . ~ . X X . . X ^ < < < < ~ X . . . > > > > > v . . . ~ . . X X 
. . . . . . . . . ~ . . . . . . X . . . X . . . . . ~ . X . ^ < < < < < < < < X X > > > v . . . . . 
. . . . . . ~ . . ~ . . X . . . . . . . . . . ~ . . . . . . . . . X . . ~ . ^ < < X ~ . v . . X . . 
~ . . . . . X X . . . . . . . . . X ~ ~ . . . . . . . . X . X X X . . . . . . . ^ X . . > v . . . . 
. ~ . . . . . . . . . . X . X X . . ~ X . . . . . ~ . ~ . X X . . X . . ~ . . . ^ < < < < DG. . . X 
~ X . . . . . X . X . . X . . X . X . . . . . . X . ~ . . . X . . . . . . . . . . . . . . . X . X . 
. ~ . . . . ~ . . X . . . . ~ X . . . . . . . . X . . . . . . ~ . X . X . . . . . . X X . . . X X . 
. . ~ . . ~ X . . . . . . . . ~ . . . . X . . . . X . . . . . . . . . . . ~ X . . ~ . . . . . . X . 
. X . ~ X X . . . . . . . X ~ . ~ . . . X . . . X . . . . ~ . . . . . . . . X . . . . . X . . X . . 
